BottomMap.map
40,40
20,20
PPPPPPPPPPPPPPPPPPPPDDDDDDDDDSSSSSSSSSSS
PPPOTopMap.map,PPPPPPPPPPPPPPPDDDDDDDDDDSSSSSSSSSSS
PPPPPPPPPPPPPPPPPPDDDDDDDDDDDDSSSSSSSSSS
PPPPPPPPPPPPPPPPPDDDDDDDDDDDDDSSSSSSSSSS
PPPPPPPPPPPPPPPPDDDDDDDDDDDDDDDSSSSSSSSS
PPPPPPPPPPPPPPPDDDDDDDDDDOLeftMap.map,DDDDDSSSSSSSSS
PPPPPPPPPPPPPPDDDDDDDDDDDDDDDDSSSSSSSSSS
PPPPPPPPPPPPPDDDDDDDDDDDDDDDSSSSSSSSSSSS
PPPPPPPPPPPPDDDDDDDDDDDDDSSSSSSSSSSSWWWW
PPPPPPPPPPPDDDDDDDDDDDDDDDSSSSSSSWWWWWWW
PPPPPPPPPPDDDDDDDDDDDDDDDSSSSSWWWWWWWWWW
PPPPPPPPPDDDDDDDDDDDDDDSSSSWWWWWWWWWWWWW
PPPPPPPPDDDDDDDDDDDDSSSSSWWWWWWWWWWWWWWW
PPPPPPPDDDDDDDDPPPPPPPSSSWWWWWWWWWWORightMap.map,WWWW
PPPPPPDDDDDPPPPPPPPPPPPPSSWWWWWWWWWWWWWW
PPPPPDDPPPPPPPFFFFFFFPPPPPPPWWWWWWWWWWWW
PPPPPPPPPPPFFFFFFFFFFFFPPPPPWWWWWWWWWWWW
PPPPPPPFFFFFFFFFFFFFFFFFFFFFPPPWWWWWWWWW
PPMMMMMFFFFFFFFFFFFFFFFFFFFFFFFFWWWWWWWW
PMMMMMPPPPPFFFFFFFFFFFFFFFFFFFFFFFFFFWWW
MMMMMPPPPPPPFFFFFFFFFFFFFFFFFFFFFFFFFFFF
MMMMMMMPPPPPPPFFFFFFFFFFFFFFFFFFFFFFFDDD
PPMMMMMMMPPPPPPPPFFFFFFFFFFFFFFFFFFDDDDD
PPPPMMMMMMMPPPPPPPFFFFFFFFFFFFFFDDDDDDDD
PPPPPMMMMMPPPPPPPFFFFFFFFFFFFDDDDDDDDDDD
PPPPPPMMMMMPPPPPPPPFFFFFFFFFDDDDDDDDDDDD
PPPPPPPMMMMPPPPPPPPPPPPPFFFFDDDDDDDDDDDD
PPPPPPPMMMMMPPPPPPPPPPPPPDDDDDDDDDDDDDDD
PPPPPPPMMMMMMMMPPPPPPPPPPPPDDDDDDDDDDDDD
PPPPPPMMMMMAAAMMMPPPPPPPPPPDDDDDDDDDDDDD
PPPPPMMMMAAAAAAMMMPPPPPPPPDDDDDDDDDDDDDD
PPPPMMMAAAAAAAAAAMMMPPPPPPDDDDDDDDDDDDDD
PPPMMMAAAAAAAAAAAAMMMPPPPPDDDDDDDDDDDDDD
PPPMMMAAAAAAOCenterMap.map,AAAAAMMMPPPDDDDDDDDDDDDPPPP
PPPPPMMMMAAAAAAAAMMMPPPPDDDDDDDDDPPPPPPP
PPPPPPMMMMAAAAAAMMMPPPPPDDDDDDDPPPPPPPPP
PPPPPPPMMMMAAAAMMMPPPPPDDDDDDPPPPPPPPPPP
PPPPPPPPPMMMMMMMMMPPPPDDDDPPPPPPPPPPPPPP
PPPPPPPPPPPPPMMPPPPPPPPPDDDDPPPPPPPPPPPP
PPPPPPPPPPPPPPPPPPPPPPPPPPDDDDPPPPPPPPPP