LeftMap.map
40,40
24,33
AAAAAAAAAAAAAAAAAAAAAAAAAAAAAAAAAAAAAAAA
AAAAAAAAAAAAAAADDDDDMOBottomMap.map,MDDDDAAAAAAAAAAAAA
AAAAAAAAAAAAADDDDMMMSSSMMMDDDDDAAAAAAAAA
AAAAAAAADDDDDDDWWWWSSSSSMMMMDDDDDDAAAAAA
AAAAADDDDDDDDDWWWWWSSSSSSMMMMDDDDDDDAAAA
AAAADDDDDDDDDWWWWWWWORightMap.map,SSSSSMMMMMDDDDDDAAA
AAADDDDDDDDDWWWWWWWWDFFDMMMMMMMDDDDDDOTopMap.map,AA
AAOCenterMap.map,DDDDDDDDDWWWWWWWWFFFFMMMMMMMDDDDDDDAA
AAADDDDDDDDDWWWWWWFFFFFFMMMMMDDDDDDDDAAA
AAAAAADDDDDDWWWWWFFFFFFFFMMMMDDDDDDAAAAA
AAAAAAADDDDDWWFFFFFFFFFFFMMMDDDDDAAAAAAA
AAAAAAAAAAAAFFFFFFFFFFFFFFAAAAAAAAAAAAAA
AAAAAAAAAAAAAAAAFFFFFAAAAAAAAAAAAAAAAAAA
AAAAAAAAAAAAAAAADDFFDAAAAAAAAAAAAAAAAAAA
AAAAAAAAAAAAAAAADDDDDAAAAAAAAAAAAAAAAAAA
AAAAAAAAAADDDDDDDDDDDDDDDDDDDAAAAAAAAAAA
AAAAAAADDDDDDDDDDDDDDDDDDDDDDDDAAAAAAAAA
AAAADDDDDDDDDDDDDDDDDDDDDDDDDDDDDADDDDDA
AADDDDDDDDDDDDDDDDDDDDDDDDDDDDDDAAADDDDD
AADDDDDDDDDDDDDDDDDDDDDDDDDDDDDAAAAADDDD
ADDDDDDDDDDDDDDDDDDDDDDDDDDDDDDDAAADDDDD
DDDDDDDDDDDDDDDDDDDDDDDDDDDDDDDDDAADDDDD
DDDDDDDDDDDDDDDDDDDDDDDDDDDDDDDDDDDDDDDD
DDDDDDDDDDDDDDDDDDDDDDDDDDDDDDDDDDDDDDDD
DDDDDDDDDDDDPPPPPPPPPPPPPPPDDDDDDDDDDDDD
DDDDDDDPPPPPPPPPPPPPPPPPPPPPPPPPPDDDDDDD
DDDDPPPPPPPPPMMMMMPPFFFFFFFMMMMPPPPDDDDD
DPPPPPPPPPMMMMMFFFFFFFFFFFFFFMMMMPPPPDDD
PPPPPPPPMMMMMMFFFFFFFFFFFFFFFFMMMPPPPPPP
PPPPPPPMMMMMFFFFFFFFFFFFFFFFFFFFMMMMPPPP
PPPPPPPPMMMMMMFFFFFFPPPPPFFFFFFFFMMMPPPP
PPPPPPPPAMMMMMFFFFFFPPPPPFFFFFFMMMMPPPPP
PPPPPPPPPAAMMMMMMFFFPPPPPFFFFFMMMMMAAPPP
PPPPPPPPPPAAAAMMMMMMPPPPPMMMMMMMMMAAPPPP
PPPPPPPPPPPPAAAMMMMMMMMMMMMMMMMMAAAAPPPP
PPPPPPPPPPPPPAAAAAAMMMMMMMMMMMAAAAAPPPPP
PPPPPPPPPPPPPPPPAAAAAAAMMMAAAAAAAAAPPPPP
PPPPPPPPPPPPPPPPPPAAAAAAAAAAAAAAPPPPPPPP
PPPPPPPPPPPPPPPPPPPPAAAAAAAAAAAPPPPPPPPP
PPPPPPPPPPPPPPPPPPPPPPPPPPAAPPPPPPPPPPPP