RightMap.map
40,40
5,35
AAAOTopMap.map,DDDPPPPPPPFFFFFFFFFMMMMMMSSSSSSWWWWW
AADDDDDDPPPPPPPFFFFFFFFFMMMMMSSSSSWWWWWW
AAADDDDDDPPPPPPPFFFFFFFFMMMMMSSSSSWWWWWW
AAADDDDDPPPPPPPPPFFFFFFFFMMMMSSSSWWWWWWW
AAAADDDDPPPPPPPPPPFFFFFFFMMMMMSSSWWWWWWP
AAAADDDDDPPPPPPPPPFFFFFFFMMMSSSSWWWWWWPP
AAADDDDDPPPPPPPPPPPFFFFFFMMMMSSSWWWWWWPP
AAADDDDPPPPPPPPPPPPPFFFFFFMMMSSWWWWWWWPP
AADDDDDPPPPPPPPPPPPPPFFFFFMMMSSWWWWWWPPP
AAADDDDDPPPPPPPPPPPPPPFFFFFMMMWWWWWWPPPP
AAADDDDPPPPPPPPPPPPPPPFFFFFMMMWWWWWWPPPP
AAADDDDPPPPPPPPPPPPPPFFFFFMMMWWWWWWWWPPP
AADDDDDDPPPPPPPPPPPPPFFFFMMMWWWWWWWWWWPP
AADDDDDPPPPPPPPPPPPPPPFFFFMMMWWWWOCenterMap.map,WWWWWP
ADDDDDDPPPPPPPPPPPPPPPFFFFMMMMWWWWWWWWPP
ADDDDDDDPPPPPPPPPPPPPPFFFFMMMWWWWWWWWPPP
AADDDDDDPPPPPPPPPPPPPPPFFFFMMMWWWWWWWPPP
AAADDDDDDPPPPPPPPPPPPPPPPFFFMMMWWWWWPPPP
OBottomMap.map,AADDDDDDDPPPPPPPPPPPPPPPFFFFMMMMWWPPPPP
AAADDDDDDDPPPPPPPPPPPPPPPPFFFFMMMPPPPPPP
AADDDDDDDPPPPPPPPPPPPPPPPPFFFMMMMPPPPPPP
ADDDDDDDPPPPPPPPPPPPPPPPPFFFFMMMPPPPPPPP
AADDDDDDDPPPPPPPPPPPPPPPPPFFFMMMPPPPPPPP
AADDDDDDDPPPPPPPPPPPPPPPPPFFFFMMMPPPPPPP
AADDDDDDDPPPPPPPPPPPPPPPPFFFFMMMPPPPPPPD
ADDDDDDPPPPPPPPPPPPPPPPFFFFFFMMMPPPPPPDD
ADDDDDDPPPPPPPPPPPPPPFFFFFFFMMMPPPPDDDDD
ADDDDDDDPPPPPPPPPPPPPPFFFFFMMPPPPPPDDDDD
ADDDDDPPPPPPPPPPPPPFFFFFFFMMMPPPPPDDDDDD
AADDDDDDPPPPPPPPPPFFFFFFMMMMPPPPPPPDDDDD
AADDDDDPPPPPPPPPPPFFFFFFFMMPPPPPPDDDDDDD
AAADDDDDPPPPPPPPPPPFFFFFMMMPPPPPPPDDDDDD
AAAADDDDDPPPPPPPPPPFFFFFFMMMPPPPPDDDDDDD
AAAADDDDDPPPPPPPPPPFFFFFMMMMPPPPPPDDDDDD
AAAADDDDPPPPPPPPPPFFFFFFFMMMPPPPPPDDDDDD
AAADDDDDPPPPPPPPPPPPFFFFFFMMMMPPPPPDDDDD
AADDDDDPPPPPPPPPPPPFFFFFFFMMMMMPPPPPDDDD
AADDDDDPPPPPPPPPPPFFFFFFFFFMMMMMMPPPDDDD
AADDDDDPPPPPPPPPPPPFFFFFFFFFMMMMMMPPDDDD
OLeftMap.map,DDDDDDPPPPPPPPPPPPPPPFFFFFFFMMMMMPPPDDD